на сегодняшний день существуют сотни различных алгоритмов сжатия без потерь с адаптивными и статическими моделями представления данных их все можно разбить на непересекающиеся клаыссы или семейства по способу кодирования данных каждое семейство призвано сжать текст определеныной структуры с определенной степенью эффективности и быстродействия в зависимости от того что важнее в приыложении скорость или коэффициент сжатия

ключ:
а - 4;
б - 5;
в - a;
г - b;
д - c;
е - О;
ж - П;
з - Р;
и - <;
й - 7;
к - 8;
л - У;
м - Ф;
н - Х;
о - 1;
п - 2;
р - Д;
с - Е;
т - r;
у - t;
ф - И;
х - Й;
ц - Ч;
ч - <;
ш - Ы;
щ - Ь;
ы -  ;
ь - А;
э - Б;
ю - K;
я - Л